###################
#x.......#.......x#
#.##.###.#.###.##.#
#.##.###.#.###.##.#
#.................#
#.##.#.#####.#.##.#
#....#...#...#....#
####.###.#.###.####
#  #.#.......#.#  #
#  #.#.## ##.#.#  #
####.#.# G #.#.####
#......#####......#
#......#   #......#
####.#.#   #.#.####
#  #.#.#####.#.#  #
#  #.#.......#.#  #
####.#.#####.#.####
#........#........#
#.##.###.#.###.##.#
#..#.....C.....#..#
##.#.#.#####.#.#.##
#....#...#...#....#
#.######.#.######.#
#x...............x#
###################