##################################################
#                                                #
#                                                #
#                                                #
#                                                #
#                                   x            #
#                                                #
#                                                #
#                                                #
#                                                #
#                                                #
#                                                #
#          oooo                                  #
#                                                #
#                                                #
#                                                #
#                                                #
#                                                #
#                                                #
#                                                #
#                                                #
#                                                #
#                                                #
#                                                #
##################################################
